ƒMƒ~ƒbƒN–¼,linePosMin,linePosMax,minLevel,SpawnChance(LEVELMAX‰ñ),,,,,,,,,
0,2,8,0,50,50,50,45,45,40,40,30,20,10
1,2,8,3,999,999,999,90,90,95,100,105,110,110
2,2,8,2,999,999,70,70,75,75,80,80,85,85
3,2,8,1,999,70,70,65,65,60,60,55,55,50
4,2,8,0,50,50,50,40,40,40,30,30,30,20
5,2,8,2,999,999,40,40,35,35,35,30,30,25
6,2,8,4,999,999,999,999,6,5,4,4,3,3
7,2,8,2,999,999,60,60,55,55,50,50,45,45
8,2,8,0,25,20,30,25,25,20,20,15,15,10
9,2,8,2,999,999,30,30,25,25,20,20,15,15
